# Main Countries
ORI = "countries/Orion.txt"
ANT = "countries/Antares.txt"
HYD = "countries/Hydrus.txt"
URS = "countries/Ursa.txt"
LIB = "countries/Libra.txt"
RIA = "countries/Riaa.txt"
VUL = "countries/Vulpa.txt"
COL = "countries/Columba.txt"
CET = "countries/Cetus.txt"
COR = "countries/Corvus.txt"
AQU = "countries/Aquila.txt
VEG = "countries/Vega.txt"
GRU = "countries/Grusa.txt"
AUR = "countries/Auriga.txt"
TUC = "countries/Grusa.txt"
CNI = "countries/Centauri.txt"
LAC = "countries/Lacerta.txt"
MUS = "countries/Musca.txt"
SCR = "countries/South Corvus.txt"

# Skorpii States
SKC = "countries/Skorpii Corvus.txt"
SKG = "countries/Skorpii Grusii.txt"
SKR = "countries/Skorpii Riaa.txt"

# Antarean States
SKO = "countries/Skorpius.txt"
ARA = "countries/Ara.txt"
LUP = "countries/Lupus.txt"
NOR = "countries/Norma.txt"

# Continents
FOR = "countries/Forma.txt"
CEN = "countries/Centaura.txt"
HYA = "countries/Hydra.txt""

# Hydrusite States
LEP = "countries/Lepus.txt"
CAN = "countries/Canis.txt"

# Orionite Districts
DEL = "countries/Delphinus.txt"
CIR = "countries/Circinia.txt"
GEM = "countries/Geminia.txt"
MNT = "countries/Mintaka.txt"
VEN = "countries/Venatia.txt"
LEM = "countries/Lemming.txt"

# Columban States
CMB = "countries/Columb
AKN = "countries/Aknol"
MAK = "countries/Makno"
KOV = "countries/Kovic"